1111111111111111111111111
1P00000000000000000000001
1000010000100001000010001
1000010000100001000010001
1000000000000000000000001
1000010000100001000010001
1000010000100001000010001
1000000000000C00000000001
1000010000100001000010001
1000010000100001000010001
1000000000000000000000001
1000010000100001000010001
1000010000100001000010001
10000000C0000000000C0E001
1111111111111111111111111
