11111111111111111111111111111111111111111111111111111
10000000000000000000000000000000000000000000000000011
10000000000000000000000000000000000011111111111111111
100000000000000000000000000000000000110000000000C0001
10000000000000000000000000000000P000E0000000000000001
10000000000000000000000000000000000011000000000000001
10000000000000000000000000000000000011000000000000001
10000000000000000000000000000000000011000000000000001
10000000000000000000000000000000000011111111111111111
10000000000000000000C00000000000000000000000000000001
10000000000000000000000000000000000000000000000000001
11111111111111111111111111111111111111111111111111111
