1111111111111111111
1P00000000000000001
100X000C000C000X001
1000000000000000001
1000C00000000C00001
100000000X00000E001
1111111111111111111
