1111111111111111111111111
1P0000000000C000000000001
1011111101111111011111101
1000000000000000000000001
100X0000000000000000X0001
1000000000000000000000001
1011111101111111011111101
1000000000000C0000000E001
100X0000000000000000X0001
1000000000000000000000001
1111111111111111111111111
