1111111111111111111
1C00000100000010001
1011101101110110101
1000001000000010001
1110111011101110111
1000000000000000001
1011101111101110101
1010000C00000010101
1011101111101110101
1000000000000000001
1110111011101110111
1000001000000010001
1011101101110110101
1P0C000100000010E01
1111111111111111111
