1111111111111111111111111111111
1P0000000010000000001000000C001
1011111010110111101011011101101
1010001010000100001000010001001
1010101011110101111111010101001
1000100000010100000C01010001001
1110111110010111110101010111001
1000000010010000010101000100001
1011101010011101010101110101111
1000101010000001010100000100001
1010101011111111010111110111101
1010001000000000010000010000001
1011111011111011010111010111101
1000000000001000010100010C00001
1011111111101110110101110111101
1000000C00000000000100000000E01
1111111111111111111111111111111
