1111111111111
1P0000000C001
1000000000001
100C00000C001
1000000000001
1000010000001
10000100000E1
1111111111111
