111111111111111
10000000000000L
10000C100000001
1000001P0000001
E0000010000000c
10000000E000001
111111111111111
