111111111111111
100000000000001
10000C100000001
1000001P0000001
100000100000001
10000000E000001
111111111111111
