111111111111111111111
1P0000000000000000001
111111111111111111101
100000000C00000000001
101111111111111111111
1C0000000000000000C01
111111111111111111101
100000C000000000000E1
111111111111111111111
