111111
1P00C1
100001
1C00E1
111111
