11111111111111111111111
1P000000000000000000001
10111111111111111111101
10000000000000000001001
10111111111111111101001
10100000000000000001001
10101111111111111111001
10100000000C000000000C1
10111111111111111111101
10000000000000000000101
10111111111111111110101
100000000000000C0000101
10111111111111111111101
1C00000000000000000E001
11111111111111111111111
